aXXXXbXXXXXe
XX  XX     X
X XX X     X
X XX X     X
XX  XX     X
dXXXXcXXXXXf
